PEREIRA 	IVAN	e	3
KURTTO	MORGAN	c	1
PÖSÖ	DAVID	a	2
ZOHRABI 	PEDRAM	c	2
MATTSSON	PETTER	b	3
CHAMMAS	DANI	b	3
POLI	BOBIL	e	4
GHEBRU	ALEXANDER	b	4
GYLFE	GÖRAN	e	4
JASSIM	HUSSAIN	a	2
POLI	RAMI	e	4
LINDBLOM	HENRIK	e	2
OYARZUN	JOSE	a	2
DAHLÉN	ANNIKA	a	3
SAATI	DARINEH	b	3
BOSTRÖM	TANJA	a	1
WU	HO-MING	c	1
SCHMIDT	OLIVER	c	1
NASIRI	REZA	a	3
BERGSTRÖM	ULF	c	1
ILIC	KATARINA	d	1
BRATTSTRÖM	MATTIAS	e	2
TORO 	ROBERTO	b	1
CHRISTENSEN	MARC 	d	1
STORM	STANLEY	a	4
ANGELIDIS	JAN	c	1
PIHL	MATTIAS	c	1
KARLSSON	LARS	e	2
MBORO  	ESTANISLAO	e	2
MAGNUSSON	DAVID	d	3
SPÅNG	THOMAS	b	3
CARVAJAL	OSCAR	d	2
KINDMALM	JOHAN	d	2
BIATCHON	ALAIN	c	1
BROGMAR	JOEL	b	1
PEKKANEN	JUKKA	e	3
JOHANSSON	ROBERT	c	2
RÖNNBÄCK	ALEKSANDER	a	3
ERIKSSON	MATTIAS	b	1
GENAWI	IBRAHIM	a	2
MILLER	JESPER	b	1
LUND 	ROGER	a	3
HERMANSSON	MAGNUS	e	2
EDSTRÖM	DAVID	e	1
LAU	CHILOK	b	1
JOHANSSON	MAGNUS	c	3
JAMIL	ZIAD	e	2
ROUPÉ	KRISTOFFER	b	1
BAGHERI	ALI	d	2
ADIS	MICHAEL	d	3
GRÄSLUND	THOMAS	b	2
ABLAHAD	DANNY	e	4
ALTAYR	HYDAR	e	2
JOHANSSON	JOHN-PHILIP	e	2
